1111111111
1000000001
10CC000111
1100000001
1P00000001
1000C00001
1100010001
10000C1111
1000000001
1000000001
1000000001
1111000001
11000C1111
1000000001
1000010001
1000000001
1000000001
1000C00001
1000000001
1100000001
1000000001
1000000001
1000000001
10000000E1
1111111111