1111111111111111111111111111111111111111111111111111111111111111111111111111111111111111111111111111
1000000000000000000000000000000000000000000000000000000000000011111111110000000000000C000000C0000001
100000000P000000000111111111111000000000100000000000000000000000000000000C00000000000000000000000001
100C00000000000000CCCC000000111110001111110000000C000000000000000000000CCC000000C0000011000111111111
1CC00000110000000000000000CC000000000E000000011111111110000000C0000000000001111000000111000000000011
1111111111111111111111111111111111111111111111111111111111111111111111111111111111111111111111111111