11111111111111111
100000C1111000001
100P0000001000001
10000000000000001
1110000E000000001
100000000C0000001
100000000000000E1
11111111111111111