1111111111
1000000001
100E000C01
100C00P001
1111111111