11111111111111111
10P00000000000C01
10001100001100001
10000000000000001
1C010000C00010001
1001100C000110001
10011111111110C01
100000C00000000E1
11111111111111111